NO ./path_to_the_north_texture
SO ./path_to_the_south_texture
WE ./path_to_the_west_texture
EA ./path_to_the_east_texture 123
F 220,100,0
C 225,30,0

111111
111011
101001
111111