NO ./images/wall_s.xpm
SO ./images/wall_n.xpm
WE ./images/wall_e.xpm
EA ./images/wall_w.xpm
F 252,13,2
C 255,255,255


        1111111111111111111111111
        1000000000110000000000001
        1011000001110000000000001
        1001000000000000000000001
111111111011000001110000000000001
100000000011000001110111111111111
11110111111111011100000010001
11110111111111011101010010001
11000000110101011100000010001
10000000000000001110000011001
10000000000000001 11010000001
1100000111010101 1011100W0111
11110111 1110101 111110100001
11111111 1111111 111111111111