NO ./images/no_bricks1.xpm
SO ./images/so_bricks2.xpm
WE ./images/we_beach2.xpm
EA ./images/ea_beach1.xpm
F 252,13,2
C 255,255,255

        1111111111111111111111111
        1000000000110000000000001
        1011000001110000000000001
        1001000000000000000000001
111111111011000001110000000000001
100000000000000001110111111111111
11110111111111011100000010001
11110111111111011101010010001
11000000110101011100000010001
1000000000000000111000S011001
10000000000000001 11010010001
1100000111010101 101111000010
11110111 1110101 111110110001
11111111 1111111 111111111111