NO ./la_moon.xpm
SO ./la_piano.xpm
WE ./la_poster.xpm
EA ./la_two_on_piano.xpm
C 14, 12, 50
F 14, 12, 50

        1111111111111111111111111
        1000000000110000000000001
        1011000001110000000000001
        1001000000000000000000001
111111111011000001110000000000001
100000000011000001110111111111111
11110111111111011100000010001
11110111111111011101010010001
11000000110101011100000010001
10000000000000001110000011001
10000000000000001 11010010001
1100000111010101 1011110N0111
11110111 1110101 111110110001
11111111 1111111 111111111111