NO ./images/p_m_1.xpm
WE ./images/p_m_2.xpm
SO ./images/p_m_3.xpm
EA ./images/p_m_4.xpm
C 77, 55, 123
F 14, 12, 50

        111111
        100E01
        111111